TotalWaves;TotalSpawnPoints;ImmunityReward;SP0;SP1
int;int;float;string;string
15;2;100;4,0,50;0,0,0
15;2;100;0,0,0;2,1,50
15;2;100;4,0,50;2,0,50
15;2;100;8,1,50;2,0,50
15;2;100;10,0,50;5,1,50
15;2;100;10,1,50;10,0,50
15;2;100;20,0,50;25,1,50
15;2;100;15,1,50;15,0,50
15;2;100;30,0,50;20,1,50
15;2;100;20,1,50;30,0,50
15;2;100;30,0,35;15,1,50
15;2;100;20,1,20;20,0,50
15;2;100;30,0,20;20,1,50
15;2;100;40,0,20;20,1,50
15;2;100;50,0,20;30,1,50
